  ####
###  ####
#     X #
# #  #X #
# D D#O #
#########