   #####
####   #
#DD#XX #
# DDX  #####
# O# # #   #
#  X     X #
#  #######D#
####     ###