   ###
  ## # ####
 ##  ###  #
## X      #
#   OX #  #
### X###  #
  #  #DD  #
 ## ##D  ##
 #      ##
 #     ##
 #######