   ########
   #      #
#### #### #
# X X DD# #
# #  D# # #
# # ### # #
# #D# X   #
# #DXOD  ##
# #X###  #
#  D     #
##########