##########
#        #
#  X X X #
##O##### #
#   D D D#
#        #
########## 