##      ##      ##
##      ##      ##
######  ######  ######
##  ##  ##  ##  ##  ##
######  ######  ######