9 9
1 1 1 1 1 1 1 1 1
1 2 0 0 1 1 1 1 1
1 0 3 3 1 1 1 1 1
1 0 3 0 1 1 1 4 1
1 1 1 0 1 1 1 4 1
1 1 1 0 0 0 0 4 1
1 1 0 0 0 1 0 0 1
1 1 0 0 0 1 1 1 1
1 1 1 1 1 1 1 1 1

0代表路
1代表墙
2代表玩家
3代表箱子
4代表炸弹
6代表又有玩家又有炸弹，只显示玩家
7代表又有箱子又有炸弹，只显示箱子