XXXXXXXXXXXXXXXXXXX
X###X########X####X
X##XD########DX###X
X#################X
X###B########B####X
X#################X
X#################X
X#################X
X#################X
X###B########B####X
X#################X
X##XD########DX###X
X###X########X####X
XXXXXXXXXXXXXXXXXXX