###########
#####*#####
#####o#####
##* os#####
####o o*###
####*######
###########