########
## s ###
##o#o  #
#    # #
# **oo*#
## * ###
###  ###
########