6
10 8 8 
0 0 1 1 1 0 0 0
0 0 1 4 1 0 0 0 
0 0 1 0 1 1 1 1
1 1 1 3 0 3 4 1
1 4 0 3 2 1 1 1 
1 1 1 1 3 1 0 0 
0 0 0 1 4 1 0 0 
0 0 0 1 1 1 0 0 

93 9 9
1 1 1 1 1 0 0 0 0 
1 2 0 0 1 0 0 0 0
1 0 3 3 1 0 1 1 1
1 0 3 0 1 0 1 4 1
1 1 1 0 1 1 1 4 1
0 1 1 0 0 0 0 4 1
0 1 0 0 0 1 0 0 1
0 1 0 0 0 1 1 1 1
0 1 1 1 1 1 1 1 1

118 7 10
0 1 1 1 1 1 1 1 0 0
0 1 0 0 0 0 0 1 1 1
1 1 3 1 1 1 0 0 0 1
1 0 2 0 3 0 0 3 0 1
1 0 4 4 1 0 3 0 1 1
1 1 4 4 1 0 0 0 1 0
0 1 1 1 1 1 1 1 1 0

33 8 6
0 1 1 1 1 0
1 1 0 0 1 0
1 2 3 0 1 0
1 1 3 0 1 1 
1 1 0 3 0 1 
1 4 3 0 0 1
1 4 4 5 4 1
1 1 1 1 1 1

51 8 8 
0 1 1 1 1 1 0 0 
0 1 0 0 1 1 1 0
0 1 2 3 0 0 1 0 
1 1 1 0 1 0 1 1
1 4 1 0 1 0 0 1
1 4 3 0 0 1 0 1
1 4 0 0 0 3 0 1
1 1 1 1 1 1 1 1

186 11 13
0 0 0 1 1 1 1 1 1 1 0 0 0 
1 1 1 1 0 0 0 0 0 1 0 0 0 
1 0 0 0 4 1 1 1 0 1 0 0 0 
1 0 1 0 1 0 2 0 0 1 1 0 0 
1 0 1 0 3 0 3 1 4 0 1 0 0 
1 0 1 0 0 5 0 0 1 0 1 0 0 
1 0 4 1 3 0 3 0 1 0 1 0 0 
1 1 0 0 0 0 1 0 1 0 1 1 1 
0 1 0 1 1 1 4 0 0 0 0 0 1 
0 1 0 0 0 0 0 1 1 0 0 0 1 
0 1 1 1 1 1 1 1 1 1 1 1 1
