#=##################
#===####===#===#== 
###===########=====#
####=####==##=====##
###===#######===####
###====##==##==######
##====#==#####===###
####=============###
#######=######====##
The score is: