####################
#==================#
#==================#
#==================#
#==================#
#==================#
#==================#
#==================#
############======##

