##########
##     ###
##o###   #
# s o  o #
# **# o ##
##**#   ##
##########