#####################
# #           #     #
#     ###   # # # ###
#         # # # #   #
### ### # # # # ### #
#         # # #   # #
#   ### ### # # ### #
#       #   #   #   #
##  ## ## ####### ###
#         #         #
#   ### ### ####### #
      #   #       # #
##    ### ####### # #
#         # #   # # #
# # ### # # # # # ###
#       # # # # #   #
# ### # # # # ##### #
# #   # # # # #     #
# # # # # # # # ### #
#   #       #   #   #
#####################
11 0
2 3
19 12

