#####################
#                   #
#     ###   #     ###
#   #   # # # # #   #
######### # # # ### #
#       # # # #   # #
# ##### ### # # ### #
#   #   #   #   #   #
### ##### # ## ## ###
#         #         #
# ##### ### ### # # #
# #   #   #       # #
##### ### ####### # #
#     #     #   # #  
# ##### # # # # # # #
# #   # # # # #     #
# ### # # # # ##### #
# #   # # # # #     #
# # # # # # # # ### #
#   #   #       #   #
#####################
13 20
2 16
1 1
9 14
19 19
