##     ##     ##      #
##     ##     ##      #
###### ###### ######  #
##  ## ##  ## ##  ##  #
@##### @##### @#####  @