 ***    ***   ******  ***   ****          ****    ***   ****   ****  ****    **** 
 ***   ****  ******** ***   ****          ****    ***   ****   ****  ****    **** 
  ***  ***  ****  *** ***   ****           ****  ****   ****   ****  ****    **** 
  *** ****  ****  *******   ****           ****  ****   ****   ***** ****    ***  
   ******   ***   *******   ****           ****  ****   ****   ***** ****    ***  
   ******   ***    ******   ****           ****  ****   ****   **********    ***  
    ****    ***    ******   ****           ****  ****   ****   **********    ***  
    ****    ***    ******   ****            ***  ***    ****   **********    ***  
    ****    ***    ******   ****            ********    ****   *** ******    ***  
    ****    ***   *******   ****            ********    ****   *** ******     **  
    ****    ****  *******   ****            ********    ****   ***  *****         
    ****     ***  *** ****  ***             *** ****    ****   ***  *****    **** 
    ****     ********  ********             ***  ***    ****   ***   ****    **** 
    ****       ****     *****               **    **    ****   ***   ****    **** 