 ###    ###   ######  ###   ####          ####    ###   ####   ####  ####    #### 
 ###   ####  ######## ###   ####          ####    ###   ####   ####  ####    #### 
  ###  ###  ####  ### ###   ####           ####  ####   ####   ####  ####    #### 
  ### ####  ####  #######   ####           ####  ####   ####   ##### ####    ###  
   ######   ###   #######   ####           ####  ####   ####   ##### ####    ###  
   ######   ###    ######   ####           ####  ####   ####   ##########    ###  
    ####    ###    ######   ####           ####  ####   ####   ##########    ###  
    ####    ###    ######   ####            ###  ###    ####   ##########    ###  
    ####    ###    ######   ####            ########    ####   ### ######    ###  
    ####    ###   #######   ####            ########    ####   ### ######     ##  
    ####    ####  #######   ####            ########    ####   ###  #####         
    ####     ###  ### ####  ###             ### ####    ####   ###  #####    #### 
    ####     ########  ########             ###  ###    ####   ###   ####    #### 
    ####       ####     #####               ##    ##    ####   ###   ####    #### 