###O#############
#       #       #
# ##### # ##### #
# #           # #
# # ########### #
# # #   #     # #
# # # ##### #   #
### # #     #####
# # # #######   #
# #         # # D
# ##### ##### # #
#       #     # #
# ############# #
#               #
#################       