#####################
# #           #     #
#     ###   # # # ###
#   #   # # # # #   #
######### # # # ### #
#       # # # #   # #
# ##### ### # # ### #
#   #   #   #   #   #
### ##### ####### ###
#         #         #
# ##### ### ####### #
  #   #   #       # #
##### ### ####### # #
#     #   # #   # #  
# ##### # # # # # ###
# #   # # # # # #   #
# ### # # # # ##### #
# #   # # # # #     #
# # # # # # # # ### #
#   #   #   #   #   #
#####################

