*O********
* ****** *
*    *** *
**** *** *
***    * *
****** * *
*      * *
* ****** *
*        *
*X********