14 25
###########################
#        ##  #  #  #  #   #
## # #      ##   # #  ##  #
## #       ##     #  #### #
#  #         # #     ##   #
#  ###   #     ### #  #   #
#       #             ##  #
#   ###  ## # ## ##   #   #
#   #  # #  #       o # ###
#    #   #  #  #  #  #### #
##O##  ##    # ##     #  ##
#####  #  ###        ## # #
#         #   #####  ###  #
# # #      # #  #     # # #
##    #  #   #     #  # ###
######################## ##
0