19 20
######################
#       # #  ##    # #
#   # #  ##       ## #
# #  # # #        # ##
# #  # # ## ###     ##
#     # # #        # #
#  #  #   #  #    # ##
#     ##      #   ## #
##   ###   ###  ### ##
# #     # ###    # ###
# # ##      #  #   # #
###  #o# #  # O# ##  #
##                  ##
# ##### ## ##     #  #
#   ## # #   #  #### #
##    #        ##  ###
# #  #           #  ##
##          #   #  ###
# ##    #      ## #  #
##     ##   #  ##  ###
######################
0