11 30
################################
#     # #   # ## ## # #  # ###O#
####     O     ##         #  # #
# ### ## #   #   ##  #         #
#    # #   ##   ##   #### ##   #
# ##  #      # #  #   #   ###  #
# #   # ##          o     #  # #
## ## ##    ###  #    ##  ## # #
## ##  # ## ##    ###  ### #   #
#    #      # # #  #      ##   #
# #    ## o      #  ### #      #
# # #      # ##   #      # #   #
################################
0
