11 21
#######################
#  ##  ##  O#         #
# # ##     #  #   # # #
#    ##     # #    #  #
#    #       #    ## ##
#  #   #    # ### # # #
###   ##   o        # #
# #       #  #     #  #
# #  ###       ##    ##
##   ##        # # ## #
## # ##               #
#        # # #       ##
#######################
0
