11 24
##########################
#    #    #      #   # # #
###  ##            ## #  #
# #o     # #     #   #   #
#    #  # #     # # ##   #
##       # #O  ##  ##  ###
##       ###   ##    ##  #
####     #    #       ####
#       # ### ##       # #
# o  #        # #  #   # #
## ###     #           O #
##         #   #       # #
##########################
0
