##########
#  o+ +o #
#        #
# @      #
#    #####
#        #
#  +  o  #
#####    #
#        #
##########!
