# ########################## #
#        #             #     #
#        #             #     #
#        #             #     #
#        #             #     #
#        #             #     #
#        #             #     #
#                            #
#                            #
##############################
records: