# ########################## #
#        #             #     #
#    ##      ##### ## #    # #
## #  # ### ##     #      #  #
#            #     # # ##  # #
#  ########  ## #  #       # #
#         #  #  #       #    #
#    ##         #  #    # ## #
#         #                  #
##############################
records: