# ########################## #
#        ##             #    #
#    ##         ## ## #    # #
## #  # ###  #   # #       # #
#        #  ##     # # ### # #
#  ####  ##  ## #  # #     # #
#         #  #  #       #    #
#    ##     # # #  # # # ### #
#                            #
##############################
records: