# ########################## #
#                 # # #   #  #
#      ########  #        #  #
#   # #          # #  # # #  #
#  ## #   ### ## # #  # # #  #
##        # # #       # # #  #
# ### # # # # # ## #  # # #  #
# # # # #   ### ####  #      #
#   #   ##              #    #
##############################
records£º