##############
#            #
#            #
#            #
#  B         #
#            #
###O##########
