#####################
#                   #
################### #
#                 # #
# ############### # #
# #             # # #
# # ########### # # #
# # #         # # # #
# # # ####### # # # #
# # # #     # # # # #
# # # # ### # # # # #
# # # # #   # # # # #
# # # # ##### # # # #
# # # #       # # # #
# # # ######### # # #
# # #           # # #
# # ############# # #
# #               # #
# ################# #
#                   #
#####################
